--------------------------------------------------------------------------------------------------------------------------------------------------------------------------------------------------------------------------------------------------------------------------------------------------------------------------------------------------------------------
--------------------------------------------------------------------------------------------------------------------------------------------------------------------------------------------------------------------------------------------------------------------------------------------------------------------------------------------------------------------
--------------------------------------------------------------------------------------------------------------------------------------------------------------------------------------------------------------------------------------------------------------------------------------------------------------------------------------------------------------------
--------------------------------------------------------------------------------------------------------------------------------------------------------------------------------------------------------------------------------------------------------------------------------------------------------------------------------------------------------------------
------------------------------------------------------------------------------------------------------------XX------------------------------------------------------------------------------------------------------------------------------------------------------------------------------------------------------------------------------------------------------
----------------------------------------------------------------------------------XXXXXXXXXXXXXXXXXXXXXX------------------------------------------------------------------------------------------------------------------------------------------------------------------------------------------------------------------------------------------------------XXX---
------------------------------------------------------------------------------------[]-------[]---------------------------------------------------------------------------------------------------------------------------------------------------------------------------------------------------------------------------------------------------------------XXX---
------------------------------------------------------------------------------o-----[]-------[]---------------------------------------------------------------------------------------------------------------------------------------------------------------------------------------------E-----------------------------------------------------------------XXX---
------------------------------------------------------------------------------------[]-------[]---------------------------------------------------------------------------------------------------------------------------------------------------------------------------------------------<>-----------------------------E----------------------------------XXX---
---------Q-E------------------------------X-----------------------------------------[]-------[]-----------------------------------------------------------------------------------------------------X-----------------------------------------------------------------------------S-------S-[]----------------------------<>-------------------------X--------XXX---
-----------E-----------------------------XXXXXXXXXXXXXXXXXXXXXXXXXXXXXXX------------<>-------<>----------------------------------------------------------------------------------------------------XXXXXXXXXXXXXX---XXX---XXX---XXXX--------------------------------------------E-------E---[]----------------------------[]-------------------------X--------XXX---
----------------------------------------XXXXX---------------------------------E-------------------------------------------------------------------------------------------------------------------XXXXX-------------XX----XX----XXX---------------------------------------------------------[]------------------------E---[]-------------------------X--------XXX---
---X--------------X-------E------------XXXXXX--------------------------------<>--X---E--------E--------------------------X-XX------------EE-E-----E-----E-------E------E------E------------------XXXXX--------------------------------------------------------------------------------------[]-------E-----E------E-------[]----E------E--------X----X--------XXX---
XXXXXXXXXXXXXXXXXXX---XXXXXXXXXXXXXXXXXXXXXXX--------------------------------[]---XXXX-XXXXXXXX-XXXXXXXXXXXX--------XXXXXXXXXXXXXX---XXXXXXXXXXXXXXXXXXXXXXXXXXXXXXXXXXXXXXXXXXXXXXXXXXXXXXXXXXXXXXXX----------------------------------XXXXXXXXX---XXXXXXXXXXXXXXXXXXXXXXXXXXXXXXXXXXXXXXXXXXX-XXXXXXXXXXXXXXXXXXXXX<>XXXXXXXXXXXXXXXXXXX<XXXXXXX----X--------XXX---
XXXXXXXXXXXXXXXXXXX---XXXXXXXXXXXXXXXXXXXXXXX--------------------------------[]----XXX-XXXXXXXX-XXXXXXXXXXXX--------XXXXXXXXXXXXXX---XXXXXXXXXXXXXXXXXXXXXXXXXXXXXXXXXXXXXXXXXXXXXXXXXXXXXXXXXXXXXXXX----------------------------------XXXXXXXXX---XXXXXXXXXXXXXXXXXXXXXXXXXXXXXXXXXXXXXXXXXXX-XXXXXXXXXXXXXXXXXXXXX<>XXXXXXXXXXXXXXXXXXX<XXXXXXX----X-XXX----XXX---
XXX XXXXXXXXXXXXXXX---XXXXXXXXXXXXXXXXXXXXXXX--------------------------------[]----XXX-XXXXXXXX-XXXXXXXXXXXX--------XXXXXXXXXXXXXX---XXXXXXXXXXXXXXXXXXXXXXXXXXXXXXXXXXXXXXXXXXXXXXXXXXXXXXXXXXXXXXXX----------------------------------XXXXXXXXX---XXXXXXXXXXXXXXXXXXXXXXXXXXXXXXXXXXXXXXXXXXX-XXXXXXXXXXXXXXXXXXXXX<>XXXXXXXXXXXXXXXXXXX<XXXXXXX----X-XXX----XXX---
