--------------------------------------------------------------------------------------------------------------------------------------------------------------------------------------------------------------------------------------------------------------------------------------------------------------------------------------------------------------------
-----------------------------------m--------------------------------------------------------------------------------------------------------------------------------------------------------------------------------------------------------------------------------------------------------------------------------------------------------------------------------
-----------------------------------?--------------------------------------------------------------------------------------------------------------------------------------------------------------------------------------------------------------------------------------------------------------------------------------------------------------------------------
-------------------------------------------------------------------------------------------n------------------------------------------------------------------------------------------------------------------------------------------------------------------------------------------------------------------------------------------------------------------------
----------------------------------m-m--mmm------------------------------nnnn--------------no--------------------------------------------------------------------------------------------------------------------------------------------------------------------------------------------------------------------------------------nnnnnnnnnnnnnnnnnnnnnnnnnnnnnnnnni
----------------------------------S-S--XXX------------------------------XXXX---------nn---XX-----------------------------------------------------------------------------------------------------------------------------------------------------------------------------------------------------------------------------------n--XXXXXXXXXXXXXXXXXXXXXXXXXXXXXXXXXX
-------------------------------------------------------------------------------------XX----------------------------------------------------------------------------------------------------------------------------------------------------------------------------------------------------------------------------------------X----------------------------------[]
------------oo-------------------------------------mm-------------------------------------------------------------------------------------------------------------------------------------------------------------------------------------------------------------------------------------------------------------------------------------------------------------[]
-----------o------------------mmmmmmE-------mmm----XX-----------mmmmm---------nnnn----------------------------------------------------------------------------------------------------------------------------------------------------------------------------------------------------------------------------------nnnnnni---------------------------------------[]
--------mmm-----------m-------XXXXXX--------XXX---------mmm-----XXXXX---------XXXX------------------------------------oo---------------------------------------------------------------------------------------------E-------------------E----------o--------------------------------------------------------------nXXXXXXX---------------------------------------[]
-------mXXX-----------X---------------------------------XXX-----------------------------------------------------n----------------------------------------------------------------------------------------------------E-------------------E------------------------------------------------------------------------nXXXX-------------------------------------------[>
------mXXXX-----------X--------------------------------------------------------------------n------------nn-n--n-E------------------------------------------------------------------------------------------n-----------------------------------------------------------------------------------------------------nXXXXX--------------------------------------------i
mmmmmmXXXXX--mmmmmmm--Xmmmmmmm--------------------------------------------------------nnnnnEnnnnnn---nnnEEnEnnEnbnnnnnnnnnnnnnnnnnnnnnnnnnnnnnnnnnnnnnnnnnnnnnnnnnnnnnnnnnnnnnnnnnnnnnnnnnnnnnnnnn----nnnnnEnnnnnnnnnnnnnnnnnnnnnnnnnnnnnnnnnnnnnnnnnnnnnnnnnnnnnnnnnnnnnnnnnnnnnnnnnnnnnnnnnnnnnnnnnnnnnnnnnnnnnXXXXXX----------nnnnnnnnnnnnnnnnnnnnnnnnnnnnnnnnnnE
XXXXXXXXXX---XXXXXXX--XXXXXXXX--------------------------------------------------------XXXXXXXXXXXX---XXXXXXXXXXXXXXXXXXXXXXXXXXXXXXXXXXXXXXXXXXXXXXXXXXXXXXXXXXXXXXXXXXXXXXXXXXXXXXXXXXXXXXXXXXXXX----XXXXXXXXXXXXXXXXXXXXXXXXXXXXXXXXXXXXXXXXXXXXXXXXXXXXXXXXXXXXXXXXXXXXXXXXXXXXXXXXXXXXXXXXXXXXXXXXXXXXXXXXXXXXXXXX-----------XXXXXXXXXXXXXXXXXXXXXXXXXXXXXXXXXXX
XXXXXXXXXX---XXXXXXX--XXXXXXXX--------------------------------------------------------XXXXXXXXXXXX---XXXXXXXXXXXXXXXXXXXXXXXXXXXXXXXXXXXXXXXXXXXXXXXXXXXXXXXXXXXXXXXXXXXXXXXXXXXXXXXXXXXXXXXXXXXXX----XXXXXXXXXXXXXXXXXXXXXXXXXXXXXXXXXXXXXXXXXXXXXXXXXXXXXXXXXXXXXXXXXXXXXXXXXXXXXXXXXXXXXXXXXXXXXXXXXXXXXXXXXXXXXXXX-----------XXXXXXXXXXXXXXXXXXXXXXXXXXXXXXXXXXX
XXXXXXXXXX---XXXXXXX--XXXXXXXX--------------------------------------------------------XXXXXXXXXXXX---XXXXXXXXXXXXXXXXXXXXXXXXXXXXXXXXXXXXXXXXXXXXXXXXXXXXXXXXXXXXXXXXXXXXXXXXXXXXXXXXXXXXXXXXXXXXX----XXXXXXXXXXXXXXXXXXXXXXXXXXXXXXXXXXXXXXXXXXXXXXXXXXXXXXXXXXXXXXXXXXXXXXXXXXXXXXXXXXXXXXXXXXXXXXXXXXXXXXXXXXXXXXXX-----------XXXXXXXXXXXXXXXXXXXXXXXXXXXXXXXXXXX
