--------------------------------------------------------------------------------------------------------------------------------------------------------------------------------------------------------------------------------------------------------------------------
--------------------------------------------------------------------------------------------------------------------------------------------------------------------------------------------------------------------------------------------------------------------------
--------------------------------------------------------------------------------------------------------------------------------------------------------------------------------------------------------------------------------------------------------------------------
---------------------------------------------------------------------------------------------n-n--------------------------------------------------------------------------------------------------------------------------------------------------------------------------
-----------------------------------------------------------------------------------------nnnnEnEn-------------------------------------------------------------------------------------------------------------------------------------------------------------------------
-----------------------------------------------------------------------------------------SSSSSSSS-------------------------------------------------------------------------------------------------------------------------------------------------------------------------
--------------------------------------------------------------------------------------------------------------------------------------------------------------------------------------------------------------------------------------------------------------------------
-----------------------------------------ooo----------------------------------------------n-------------------------------------------------------------------------------------------------------------------------------------------------------------------------------
-------------------------------------mmm-----------------------------------------------nnnEnnnnnnnnnnnnnnnnnnnnnnnnnnnnnnn-------------------------------------------------------------------------------------------------------------------------nm-------m-------------
----------------------------E-------mXXX-----------------------------------------------SSSSSSSSSSSSSSSSSSSSSSSSSSSSSSSSSSS------------------------------------------------------------------m--------------------------------------------------n---XX------nX-------------
----------------------------E------mXXXX------------------------n-----------nm--------------------------------------------------------------------------------m----------------------------mE--------------------------------------------------?----X-----nXX-------------
---m-----------m------------------mXXXXX----mmmmmm--------------S--------m--<>----------------------------------------------mm-mm----------m-----------------m>--------------m----m--------<>-------m-----m----m----m----m---m----m----m----m-------X----nXXX-----nn-n----
mmmXmmmmmmmmmmmEmmmmmmmmmmmmmmmmmmXXXXXX----SSSSSSmmmmmmmmmmmm--------mmmXmm[]mmmmmmmmmmmmmmmmmmmmmmmmmmmmmmmmmmmmmmmmmmmmmmEEmEEmmmmmmmmmmEmmmmmmmmmmmm-----<]mmmmmmmmmmmmmmXmmmmXmmmmmmmm[]mmmmmmmXmmmmmXmmmmXmmmmXmmmmXmmmXmmmmXmmmmXmmmmX-------XnnnnXXXXnnnnnEEnEnnnm
XXXXXXXXXXXXXXXXXXXXXXXXXXXXXXXXXXXXXXX----------XXXXXXXXXXXXX--------XXXXXXXXXXXXXXXXXXXXXXXXXXXXXXXXXXXXXXXXXXXXXXXXXXXXXXXXXXXXXXXXXXXXXXXXXXXXXXXXXX-----[]XXXXXXXXXXXXXXXXXXXXXXXXXXXXXXXXXXXXXXXXXXXXXXXXXXXXXXXXXXXXXXXXXXXXXXXXXXXXXX-------XXXXXXXXXXXXXXXXXXXXXX
XXXXXXXXXXXXXXXXXXXXXXXXXXXXXXXXXXXXXXX----------XXXXXXXXXXXXX--------XXXXXXXXXXXXXXXXXXXXXXXXXXXXXXXXXXXXXXXXXXXXXXXXXXXXXXXXXXXXXXXXXXXXXXXXXXXXXXXXXX-----[]XXXXXXXXXXXXXXXXXXXXXXXXXXXXXXXXXXXXXXXXXXXXXXXXXXXXXXXXXXXXXXXXXXXXXXXXXXXXXX-------XXXXXXXXXXXXXXXXXXXXXX
XXX XXXXXXXXXXXXXXXXXXXXXXXXXXXXXXXXXXX----------XXXXXXXXXXXXX--------XXXXXXXXXXXXXXXXXXXXXXXXXXXXXXXXXXXXXXXXXXXXXXXXXXXXXXXXXXXXXXXXXXXXXXXXXXXXXXXXXX-----[]XXXXXXXXXXXXXXXXXXXXXXXXXXXXXXXXXXXXXXXXXXXXXXXXXXXXXXXXXXXXXXXXXXXXXXXXXXXXXX-------XXXXXXXXXXXXXXXXXXXXXX
