--------------------------------------------------------------------------------------------------------------------------------------------------------------------------------------------------------------------------------------------------------------------------------------------------------------------------------------------------------------------
--------------------------------------------------------------------------------------------------------------------------------------------------------------------------------------------------------------------------------------------------------------------------------------------------------------------------------------------------------------------
-------------------------------------------------------------------------------------------ooo--------------E---------------------------------------------------------------------------------------------------------------------------------------------------------S---------------------------------------------------------------------------------------------
-------------------------------------------------------------------------------------------XX-----------------------------------------------------------------------------------------------------------------------------------------------------------------------------------------------------------------------------------------------------------------------
------------------------------------------------------------------------------------------------------------------------------------------------------oo------------------------------------o---------------o---------------o---------------------------------------------------------------------------------------------------------------------------------------
---------------------------------------------------------------------------X---XX--X---------X---------------------------------------------------XXX------oo-----XXX-------------------XXX-----oo------XXX----o--------XXX-----oo-----------------------------------XXXXXXXXXXXXXXXXXXXXXEXXXXXXXXXXXXXXXXXXXXXXXXXXXXXXXXXXXXXXXXXXXXXXXXXXXXXXXXXXXXXXXXXXXXXXXXXX
------------------------------------------------------------------------------------------------------------X------------------------------------------------------------------oooo---------------------------------------------------------------------------------XXX---------------------------------------------------------------------------------------------
-----------------------------------------------------------------------------ooooooooo-------------X---------------------------------------------------------------------------oo-o---------------------------------------------------------------------------------------------------------------------------------------------------------------------------------
-----------------------------------------------------------------------------ooooooooo--------XXX-------------------------------------------------------------------------------------------------------------------------------------------------------------------------------------------------------------------------------------------------------------------
--------------------------------------------EE-E---EE-E-EXXXXXXXXXXXXXXXX--------------XXX-------------------------------------------------------------XXX--XXX-------------------XXX-------XXX--XXX--------XX-XXXXX--------XXX----------------------------------------XXXXXXXXXXXXXXXXXEXXXXXXXXXXXXXXXXXXXXXXXXXXXXXXXXXXXXXXXXXXXXXXXXXXXXXXXXXXXXXXXXXXXXXXXXXXX
-------XXXXXXXXXXXXXXXXXXXXXXXXXXXXXXXXXXXXXXXXXXXXXXXXXXX----------------------------------------------------------------------------------------------------------------------------------------------------------------------------------------------------XX----------------------------------------------------------------------------------------------------
------XXXXX------------------------------------------------------------------E----------------------------------------------------------------------------------------XXXXXXXXX-----------------------------------------------------------------------------XXX-----------------------------------------------------------------------------------------------------
---X-XXXXXX-----------------------------------------------------------------<>---------------------------------------------------------------------------------------------------------------------------------------------------XXXXXXXXXXXXX---------------------XX-----------------------------------------------------------------------------------------------
XXXXXXXXXXX-----------------------------------------------------------------[]---------------------XXXXXXXXXXX--XXXXX--XXXX--XXXXXX---XXXXX--------------------------------------------------------------------------------------------XX---XX-XXXXXXXXXXX---------XXX----------------------------------------------------------------------------------------------
XXXXXXXXXXX-----------------------------------------------------------------[]---------------------XXXXXXXXXXX--XXXXX--XXXX--XXXXXX---XXXXX--------------------------------------------------------------------------------------------XX---XX---------------------XXX----------------------------------------------------------------------------------------------
XXX XXXXXXX-----------------------------------------------------------------[]---------------------XXXXXXXXXXX--XXXXX--XXXX--XXXXXX---XXXXX--------------------------------------------------------------------------------------------XX---XX---------------------XXX----------------------------------------------------------------------------------------------
