------------------------------------------------------------------------------------------------------------------------------------------------------------------
-----------------------------------------------------------------------------------------------------------------------------------------------------------------
-------------------------------------------------------------------------------------------------------------------------------S---------------------------------
-----------------------------------------------------------------------------------------------------------------------------------------------------------------
---------------------------------------E----------------------------------------------------------------------------------------o--------------------------------
--------SS-----------------------------------------------------------XX----------------------------------------SSS--------XXXX-S?--------------------------------
------------------------------------------------------X--------------XX--------E-------------------------------------------------------E-------------------------
----------------------------------------------------XXX------------X-XX--------XX--------------------------------------------------------------------------------
----------------E--X--------------------X-----------XXX------------X-XX--------XX------------S-------------------------------------------------------------------
----------------X-----------------o----------o--E---XXX------------X-XX-----E--XX----------E-----o------------X----------------S----------------S---------------o
---------XX-----X----------------------------o--X---XXX------------X-XX--------XX----------------o------------X---S-SS-------------------------------------------
---------XXX----X--------<>---------------------X---XXX------------X-XX--------XX-----------------------------X----SSSS------------------------------------------
---X-----XXX----X--------[]E--------------------X---XXX---X--------X-XX--------XX----------------X------------X----SSSS------------------------------------------
XXXXXXXXXXX-XXXXXX----XXXXXXXXXXXXXXXXXXXXXXX---X---XXX---X--------X-XXXXXXXXXXXX-----XXXXXXXXXXXXXEEXEEEXEEXEXXXX-XXX-XX------XXXXEXEXXXEXXEXXXXXEXXXXXXXXXXXXXX
XXXXXXXXXXXXXXXXXX----XXXXXXXXXXXXXXXXXXXXXXX---X---XXX---X--------X-XXXXXXXXXXXX-----XXXXXXXXXXXXXXXXXXXXXXXXXXXX-XXX-XX------XXXXXXXXXXXXXXXXXXXXXXXXXXXXXXXXXX
XXX XXXXXXXXXXXXXX----XXXXXXXXXXXXXXXXXXXXXXX---X---XXX---X--------X-XXXXXXXXXXXX-----XXXXXXXXXXXXXXXXXXXXXXXXXXXX-XXX-XX------XXXXXXXXXXXXXXXXXXXXXXXXXXXXXXXXXX
