-----------------------------------------------------------------------------------------------------------------------------------------------------------------------------------------------------------------------------------------------------------------------------------------------------------------
-----------------------------------------------------------------------------------------------------------------------------------------------------------------------------------------------------------------------------------------------------------------------------------------------------------------
-----------------------------------------------------------------------------------------------------------------------------------------------------------------------------------------------------------------------------------------------------------------------------------------------------------------
-----------------------------------------------------------------------------------------------------------------------------------------------------------------------------------------------------EE----------------------------------------------------------------------------------------------------------
---------------------------------------------------------------------------------------------------------------------------------------------------------------------------------------------XXX?XXXXXXXXXXXXXX--------------------------------------------------------------------------------------------------
-----------------------------------------------------------------------------------------------------------------------------------------------------------------------------------------------------[]----------------------------------------------------------------------------------------------------------
--------------------------------------------------------------------------------------------------------------------------------SSS---SSS------------------------------------------------------------[]----------------------------------------------------------------------------------------------------------
-----------------------------------------------------------------------------------------------------------------------------------------------------------------------------------------------------[]---------------------------------------------------------------------------XXXX---------------------------
-----------------------------------------------------------------------------------------------------------------------------------------------------------------------------------------------------<>------------XSSS-S--------------------------------------------------------XXXXX--------------------------X
--------------------------------------------------------------XX----------------------------------ooo---------------------------XXQ?XXX----------------o-o-o------------------------------------------------------XXX-----------------------------------------------------------XXXXXX---------------------------
-------------SS----------------------------S?SSX--------------XX------------------<>-------------ooooo---------------E---E------X----------------------------------------------X---------------------------------XXXX----------------------------------------------------------XXXXXXX---------------------------
-------------------------------------b-----E----------------XXXXX-----------------[]--------------------------------------------X------------------------------------b---------X--------------------------------XXXXX---------------------------------------------------------XXXXXXXX----------<>---------------
---------------E------EE-------------B---------------------XXXXXX-----------------[]--------------------------------------------X------------------------------------B---------X--------------E----------------XXXXXX------------SSSSSS--------------------------SSSS--------XXXXXXXXX----------[]-E-E--------E--
XXXXXXXXXXXXXXXXXXXXXXX----XXXXXXXXXXXXXXXXXXXXXXXXXXXXXXXXXXXXXXXXXXXXXXXXXXXXXXXXXXXXXXXXXXXXEXEXXXXXXXXXXXXXXXXXXXXXXXXXXXXXXXXXXX---------XXXXXXXXXXXXXXXXXXXXXXXXXXXX-----XXXXXXXXXXXXXXXXXXXXXXXXXXXXXXXXXXXXXXXXXXX---------X-------XXXXXXXXX---XXX----XXX---X-XXXXXXXXXXXXXXX---XXXXXXXXXXXXXXXXXXXXXXXXX
XXXXXXXXXXXXXXXXXXXXXXX----XXXXXXXXXXXXXXXXXXXXXXXXXXXXXXXXXXXXXXXXXXXXXXXXXXXXXXXXXXXXXXXXXXXXXXXXXXXXXXXXXXXXXXXXXXXXXXXXXXXXXXXXXX---------XXXXXXXXXXXXXXXXXXXXXXXXXXXX-----XXXXXXXXXXXXXXXXXXXXXXXXXXXXXXXXXXXXXXXXXXX-----------------XXXXXXXXX---XXX----XXX---X-XXXXXXXXXXXXXXX---XXXXXXXXXXXXXXXXXXXXXXXXX
XXXXXXXXXXXXXXXXXXXXXXX----XXXXXXXXXXXXXXXXXXXXXXXXXXXXXXXXXXXXXXXXXXXXXXXXXXXXXXXXXXXXXXXXXXXXXXXXXXXXXXXXXXXXXXXXXXXXXXXXXXXXXXXXXX---------XXXXXXXXXXXXXXXXXXXXXXXXXXXX-----XXXXXXXXXXXXXXXXXXXXXXXXXXXXXXXXXXXXXXXXXXX-----------------XXXXXXXXX---XXX----XXX---X-XXXXXXXXXXXXXXX---XXXXXXXXXXXXXXXXXXXXXXXXX
