------------------------------------------------------------------------------------------------------------------------------------------------------------------------------------------------------------------------------------------------------------------------------------------------------------------------------------------------------------------------------------------------------------------------------------------------------------------------------------------------------------------------------------------------------------------------------------------------------------------------------------------------------------------------------------------------------------------------------------------------------------------------------------------------------------------------------------------------------------------------------------------------------------------------------------------------------------------------------------------------------------------------------------------------------------------------------------------------------------------------------------------------------------------
------------------------------------------------------------------------------------------------------------------------------------------------------------------------------------------------------------------------------------------------------------------------------------------------------------------------------------------------------------------------------------------------------------------------------------------------------------------------------------------------------------------------------------------------------------------------------------------------------------------------------------------------------------------------------------------------------------------------------------------------------------------------------------------------------------------------------------------------------------------------------------------------------------------------------------------------------------------------------------------------------------------------------------------------------------------------------------------------------------------------------------------------------------------
--------------------------------------------------------------------------------------------------------------------------------------------------------------------------------------------------------------------------------------------------------------------------------------------------------------------------------o----------------------------------------------------------o---------------------------------------------------------------------------------------------------------------------------oo-----o-----o-------oo-----o-------------oo-------oo-----oo-----o------o-----o----------oo-----o-----oo-----------o-------oo------------o------------o-----o--------o-----oo--------o-----oo-----o---------o-----o--------oo-----------o-----o-----------o----oo--------oo----------o--------o---------o-----o----------o--------------oo-------o----oo-----o-----o-----o--------o----------------o-----oo------------oo------o--------o----oo-----o-----------------o---------o-----o-----oo-----o-----o-----oo-----o-----o---------------o------------oo-----oo-----o---------o----oo----oo-----o----oo--------------o------o-------oo--
------------------------------------------------------------------------------------------------------------------------------------------------------------------------------------------------------------------------------------------------------------------------------------------------------------------------------------------------------------------------------------------------------------------------------------------------------------------------------------------------------------------------------------------------------------------------------------------------------------------------------------------------------------------------------------------------------------------------------------------------------------------------------------------------------------------------------------------------------------------------------------------------------------------------------------------------------------------------------------------------------------------------------------------------------------------------------------------------------------------------------------------------------------------
-------------------------oooooo----EEEEEE-EEE-EEEEEEEEEEEEEEEEEEEEEEEEEEEEE-EEEE-EEEEEEEEEEEEEE-EEEEEEEEEEEEEEEEEEEE-EEEEEEEEEE-EE-EEEEEEEE-EEEEEEEEEEEE-EE-EEEEEE-EEEEEEEEEEEEEEEEEEEE-EEEEEEEEEE-EEEEEEEEEE-EEEE-EE-EE-EEEE-EEEEEEEEEE-EEEEEEEEEEEEEEEE------E--------------------------------E---------------E--E--EooXXX-XXX-------------------------------------o-------------------------X--------------------------------------------------------------------------------------------------------------------------X-----X-----X--------X-----X--X-----------X--X-----X------X------X-----X-----X--X--------X------X-----X--X--X-----X--X-----X--X---XX-X--X--XX--X-----X-----X--X-----X------X--X-----X------X-----X---X-----X-----X---X-----X--X--X-----X-----X--X--X-----X-----X--X------XX--XX-----X--X-----X--XX-----X-----X----X-----X---X----X------X--X----X-----X-----X-----X-----X--X-----X--X----X--X-----X------X---X--X------XX------X-X-----X-----X-----X--X---XX--X--X----X--X-----X-----X------X-----X-----XX-----X-----X-----X--X---X--X-----X---X-X-------X------X-----X---X-----X-----X-----X-----X-----XX--X--X-X------X-----X--------X
-------------------------XXXXXX----SSSSSSSSSSSSSSSSSSSSSSSSSSSSSSSSSSSSSSSSSSSSSSSSSSSSSSSSSSSSSSSSSSSSSSSSSSSSSSSSSSSSSSSSSSSSSSSSSSSSSSSSSSSSSSSSSSSSSSSSSSSSSSSSSSSSSSSSSSSSSSSSSSSSSSSSSSSSSSSSSSSSSSSSSSSSSSSSSSSSSSSSSSSSSSSSSSSSSSSSSSSSSSSSSSSSSSS-----SSSSSSSSSS---SS-----S--S--------XSSSS------------X--X--XXX-----------o---o---------o---o-------o----------o---o---oo---o---------o--oo--oo--oo--oo--o--oo--oo--oo--oo--oo--oo--o--oo--oo--oo--oo--oo--oo--oo--oo--oo--oo--oo---oo--oo--oo--oo--oo--oo-----------------------------------------o---------------------------------------------oo--------------o--------o-----------------------------------------------------------------------------------------------------------------o--------------------------------------------------------o----------------------------------------------------------------------------------------------------o-------------------------------------------------------------------------------------------------------------------------------------------------------o--------------------o-------------------------------------------------------oo------
-------------------------------X---------------------------------------------------------------------------------------------------------------------------------------------------------------------------------------------------------------------------------------------------------------------------------------------------------------------------------------------------------------------------------------------------------------------------------------------------------------------------------------------------------------------------------------------------------------------------------------------------------------------------------------------------------------------------------------------------------------------------------------------------------------------------------------------------------------------------------------------------------------------------------------------------------------------------------------------------------------------------------------------------------------------------------------------------------------------------------------------------------------------------------
-----------------------------------------------------------------------------------------------------------------------------------------------------------------------------------------------------------------------------------------------------------------------------------------------------------------------------------------------------------------------------------------------------------------------------------------------------------------------------------------------------------------------------------------------------------------------------------------------------------------------------------------------------------------------------------------------------------------------------------------------------------------------------------------------------------------------------------------------------------------------------------------------------------------------------------------------------------------------------------------------------------------------------------------------------------------------------------------------------------------------------------------------------------------
-------------------------------------------------------------------------------------------------------------------------------------------------------------------------------------------------------------------------------------------------------------------------------------------------------------------------XXXXXXXX--------------------------------XX----S-------------S----XXXXX-----------------------------------------------------------------------------------------------------------------------XXXX---XXX---XXX-XXXXXXXX---XXX-----------XXXX-XX---XXX---XXXX---XXXX---XXX---XXX-XX-----XXXX---XXXX-XXXXX-XX-XX---XXX-XX---XXX-XX-XXX--XXXX-XXX-XX---XXX---XXX-XX---XXX---XXXX-XX---XXX---XXXX---XXX-XXX---XXX---XXX-XXX---XXX-XX-XX---XXX---XXX-XX-XX---XXX---XXX-XX---XXXXX-XXX---XXX-XX---XXX-XXX---XXX---XXX---XX---XXX--XX---XX---XXXX-XX--XXX-XXXXX---XXX---XXX---XXX-XX---XXX-XX-XXXX-XX---XXX---XXXX-XXX-XX--XXXXXX---XXXXXX---XXX-XXXXX---XXX-XX-XXXX-XX-XX-XXXX-XX---XXX---XXX---XXXX---XXX---XXXX-XXXXX---XXX---XXX-XX-XXX-XX---XXX-XXX-X----XXXX---XXXX---XXX-XXX---XXX-XXXXX---XXX---XXX---XXXX--X-XX-X---XXXX---XXX-----XXXX
------------------------------------------------------------------------------------------------------------------------------------------------------------------------------------------------------------------------------------------------------------X------------------XX--------------------XX----------X--XXXXX--------XX--XX--XXXXX-XX--XX--XX-XXX--XX--X--X---XX--XXX--XX--XXX-------XX--XX--XX--XX--X--XX--XX--XX--XX--XX--XX--X--XX--XX--XX--XX--XX--XX--XX--XX--XX--XX--XX--XXX--XX--XX--XX--XX--XX--XX-----XX----XX-------------XX----XX---X--XX--------XX----XX-----XX-----XX----XX---------XX-----XX-----------------XX-------XX----------X-------------XX----XX-------XX----XX--------XX----XX-----XX--------XX----XX--------XX----------XX----XX----------XX----XX-------XX----------XX-------XX--------XX----XX----XX---XX----X---XX---XX--------X----------XX----XX----XX-------XX---------------XX----XX------------X-------XX-------XX----------XX-----------------X--------XX----XX----XX-----XX----XX-----------XX----XX--------------XX-----------XX-----XX-----XX--------XX----------XX----XX----XX-----X-------XX-----XX------XX----
-----------------XXXXXXX?-------------------------------------------------------------------------------------------------------------------------------------------------------------------------------------------------------------------------------XX---X?-----------XXX--XX------XXX--X--------XX-XXXX--X?-------------------------------------------------------------------------------------------------------------------------------------------------------------------------------------------------------------------------------------------------------------------------------------------------------------------------------------------------------------------------------------------------------------------------------------------------------------------------------------------------------------------------------------------------------------------------------------------------------------------------------------------------------------------------------------------------------------------------------------------------------------------------------------------------------------------------X--------------X--------
-------------------------------------------------------------------------------------------------------------------------------------------------------------------------------------------------------------------------------------------------------------------------------XX--------------------XX---------------------------------------X---------- -------------------------------------------------------------------------------------------------------------------------------------------------------------------------------------------------------------------------------------------------------------------------------------------------------------------------------------------------------------------------------------------------------------------------------------------------------------------------------------------------------------------------------------------------------------------------------------------------------------------------------------------------------------------------------------------------------------------------------------------------------------------------------------------------------
---X---------------------------------------------------------------------------------------------------------------------------------------------------------------------------------------------------------------------------------------------------------------------------XX--------------------XX-------------------------------------------------- ----------------------------------------------------------------------------------------------------------------------------------------------------------------------------------------------X-------------------------------------------------X--------------------------------------------------X---------------------------------------------------------------------------------------------------------------------------------------------------------------------------------------------------------------------------------------------------------------------------------------------------------------------------------------------------------------------X-------------------------------------X---------------------------------------------------------------------------------------
XXXXXXXXXXX-X-----------XXXXXXXXXXXXXXXXXXXXXXXXXXXXXXXXXXXXXXXXXXXXXXXXXXXXXXXXXXXXXXXXXXXXXXXXXXXXXXXXXXXXXXXXXXXXXXXXXXXXXXXXXXXXXXXXXXXXXXXXXXXXXXXXXXXXXXXXXXXXXXXXXXXXXXXXXXXXXXXXXXXXXXXXXXXXXXXXXXXXXXXXXXXXXXXXXXXXXXXXXXXXXXXXXXXXXXXXXXXXXXX-------XX---------------X---------------X-----X---------X----------------------------------------- ----------------------------------------------------------------------------------------------------------------------------------------------------------------------------------------------------------------------------------------------------------------X--------------------------------------------------------------------------------------------------------------------------------------------------------------------------------------------------------------------------------------------------------------------------------------------------------------------------------------------------------------------------------------------------------------------------------------------------------------------------------------------------------------------------------------
XXXXXXXXXXX-X-----------XXXXXXXXXXXXXXXXXXXXXXXXXXXXXXXXXXXXXXXXXXXXXXXXXXXXXXXXXXXXXXXXXXXXXXXXXXXXXXXXXXXXXXXXXXXXXXXXXXXXXXXXXXXXXXXXXXXXXXXXXXXXXXXXXXXXXXXXXXXXXXXXXXXXXXXXXXXXXXXXXXXXXXXXXXXXXXXXXXXXXXXXXXXXXXXXXXXXXXXXXXXXXXXXXXXXXXXXXXXXXXX-------XX---------------X---------------X-----X---------X----------------------------------------- -------------------------------------------------------------------------------------------------------------------------------------------------------------------------------------------------------------------------------------------------------------------------------------------------------------------------------------------------------------------------------------------------------------------------------------------------------------------------------------------------------------------------------------------------------------------------------------------------------------------------------------------------------------------------------------------------------------------------------------------------------------------------------------------------------
XXX XXXXXXX-X-----------XXXXXXXXXXXXXXXXXXXXXXXXXXXXXXXXXXXXXXXXXXXXXXXXXXXXXXXXXXXXXXXXXXXXXXXXXXXXXXXXXXXXXXXXXXXXXXXXXXXXXXXXXXXXXXXXXXXXXXXXXXXXXXXXXXXXXXXXXXXXXXXXXXXXXXXXXXXXXXXXXXXXXXXXXXXXXXXXXXXXXXXXXXXXXXXXXXXXXXXXXXXXXXXXXXXXXXXXXXXXXXX-------XX---------------X---------------X-----X---------X----------------------------------------- ------------- -----------------------------------------------------------------------------------------------------------------------------------------------------------------------------------------------------------------------------------------------------------------------------------------------------------------------------------------------------------------------------------------------------------------------------------------------------------------------------------------------------------------------------------------------------------------------------------------------------------------------------------------------------------------------------------------------------------------------------------------------------------------------------------------
                                                                                                                                                                                                                                                                                                                                                                                                                                                                                                                                                                                                                          -                                                                                                                                                                                                                                                                                                                                                                                                                                                                                                                                      
