-----------------------------------------------------------------------------------------------------------------------------------------------------------------------------------------------------------------------------
-----------------------------------------------------------------------------------------------------------------------------------------------------------------------------------------------------------------------------
-----------------------------------------------------------------------------------------------------------------------------------------------------------------------------------------------------------------------------
-----------------------------------------------------------------------------------------------------------------------------------------------------------------------------------------------------------------------------
------------------------------------XX----------------------------------------------oooo-------------------------------------------------------------------------------------------------------------------------------------
-------------QQSQQ-----------?S-----------------------------------------------------XXXX----------F---------------------------------------------I---------------------!------------K-K-K------------Y-----------------EXQ----
------------------------------------------------------------------------------------X------------------------------------------------------------------------------------------ooo<><><>-----------------------------EXX-----
-------------G--S-------------------------------------------------------------------X---------------------------------------------------------------------------------------------[][][]----------------------------EXXX-----
----------------------------------------SSSSSS?-------------K-------------------------------------------------------------------X--------------------------------------------K----QQQQQQ-------------------K--------XXXXQ----
-------------?QQQQ----------S-------------------------K----<>---------------------------------XXX----------X--X----------------XX------SQ----S--Q-------------------QQQQ----<>-------------------Q--------<>-------XXXXX-----
------------------------------------XX---------------<>----[]-----K-----SS-----XXXXQ----------------------XX--XX--------------XXX-------------------------------------------[]----------------K------<>---[]------XXXXXX-----
-----------------------------------------------------[]--X-[]----<>-----SS-------------------------------XXX--XXX---------<>-XXXX-------------------------------------------[]---------------<>------[]---[]-----XXXXXXX-----
-------------------EEE--G--EEE-------------G--------E[]----[]--E-[]-----SS------------------------------XXXX--XXXX--------[]XXXXX-X----------G------------------------------[]---------------[]--X---[]--X[]----XXXXXXXX-----
XXXXXXXXXXXXXXXXXXXXXXXXXXXXXXXXXXXX----XXXXXXXXXXXXXXXXXXXXXXXXXXXXXX--XX--XXX----XXXXX-XXXXX------XXXXXXXXXXXXXXXXXXXXXXXXXXXXXXXXXXXXXXXXXXXXXXXXXXXX----XXXXXXXXXXXXXXXXXXXXXXXXXXXXXXXXXXXX-XXX-XX--XXXXX-XXXXXXXXXXXXXX
XXXXXXXXXXXXXXXXXXXXXXXXXXXXXXXXXXXX----XXXXXXXXXXXXXXXXXXXXXXXXXXXXXX--XX--XXX----XXXXX-XXXXX------XXXXXXXXXXXXXXXXXXXXXXXXXXXXXXXXXXXXXXXXXXXXXXXXXXXX----XXXXXXXXXXXXXXXXXXXXXXXXXXXXXXXXXXXX-XXX-XX-XXXXXX-XXXXXXXXXXXXXX
XXXXXXXXXXXXXXXXXXXXXXXXXXXXXXXXXXXX----XXXXXXXXXXXXXXXXXXXXXXXXXXXXXX--XX--XXX----XXXXX-XXXXX------XXXXXXXXXXXXXXXXXXXXXXXXXXXXXXXXXXXXXXXXXXXXXXXXXXXX----XXXXXXXXXXXXXXXXXXXXXXXXXXXXXXXXXXXX-XXX-XX--XXXXX-XXXXXXXXXXXXXX