--------------------------------------------------------------------------------------------------------------------------------------------------------------------------------------------------------------
--------------------------------------------------------------------------------------------------------------------------------------------------------------------------------------------------------------
--------------------------------------------------------------------------------------------------------------------------------------------------------------------------------------------------------------
--------------------------------------------------------------------------------------------------------------------------------------------------------------------------------------------------------------
--------------------------------------------------------------------------------------------------------------------------------------------------------------------------------------------XX----------------
-------------------------------------------------------------------------------------------------------------------------------------------------------------------------------------------XX-----------------
-----------------------------------------XXX-----------K-------------------------------------------------------------<>----------------------------------------------------------X--------XX------------------
------------------------SSQSS---W------XXXXX----------<>---------------Q---------------------------------------------[]-------------------------------------------XXSQSS-------XXX------EXXX------------------
---------------EXX---------------------XXXXX----------[]-------------------------------------------------------------[]-------------------------------------------XX----------KXXX-----XXXXX-----------K------
--------------EXXX---XXXXXXXXXXXXXXX--XXXXXX-------X--[]-----------------------------<>------------------------------[]----------------------------SS-------------XXX--------<>XXXX----XXXXXX---------<>------
--------------XXXX---X-------------X--XXXXXX---XX-XX--[]-----------S?SQ-SSSS---------[]----------------------------XXXXXX-------------------------SSS-----S------XXXX--------[]XXXX----XXXXXX---------[]------
-------------XXXXX---X-------------XXXXXXXXX--XXX-XX--XX-----------------------------[]----------------------------XX---------------------X------SSSS-----S------XXXX--------[]XXXX----XXXXXX---------[]------
------------XXXXXX---X-------------XXXXXXXXXXXXXXXXXXXXXX------------------GGG-------[]----E-----------GGGE-------XXX-----------GEG-------XX----SSSSS-SS-SSS-S---XXXX--------XXXXXX---XXXXXXX---------[]------
XXXXXXXXXXXXXXXXXXXXXX-------------XXXXXXXXXXXXXXXXXXXXXXXXX--XXXXXXXXXXXXXXXXXXX-XXXXXXXXXXXXXXXXXXXXXXXXXX---XXXXXXXXXXXXXXXXXXXXXXX--X-XXXXXXXXXXXXXXXXXXXXXXXXXXXXXXXXXXXXXXXXXXXXXXXXXXXXXXXXXXXXXXXXXXXX
XXXXXXXXXXXXXXXXXXXXXX-------------XXXXXXXXXXXXXXXXXXXXXXXXX--XXXXXXXXXXXXXXXXXXX-XXXXXXXXXXXXXXXXXXXXXXXXXX---XXXXXXXXXXXXXXXXXXXXXXX--X-XXXXXXXXXXXXXXXXXXXXXXXXXXXXXXXXXXXXXXXXXXXXXXXXXXXXXXXXXXXXXXXXXXXX
XXXXXXXXXXXXXXXXXXXXXX-------------XXXXXXXXXXXXXXXXXXXXXXXXX--XXXXXXXXXXXXXXXXXXX-XXXXXXXXXXXXXXXXXXXXXXXXXX---XXXXXXXXXXXXXXXXXXXXXXX--X-XXXXXXXXXXXXXXXXXXXXXXXXXXXXXXXXXXXXXXXXXXXXXXXXXXXXXXXXXXXXXXXXXXXX
