--------------------------------------------------------------------------m-------------------------------------------------------------------------------------------------------[]---------------
-------------------------------------------------------------------------m-mmmmmm------------------------m------------------------------------------------------------------------[]---------------
-----------------------------------------------------------oo-----------m--ooooooo------------F---------m-m-----------------------------------------------------------------------[]---------------
--------------------------------------------------------------mmmmmmm--m---XXXXXXXmmmmmmmmmmmmmmmmmmm--m---m----------------------------------------------------------------------[]---------------
-------------------------------------------------------m-----mXXooooomm-----------ooooooooooooooooooomm-----m------------------------------------------mm-------------------------[]---------------
------------------------------------------------------m-m---m---XXXXXXX-----------XXXXXXXXXXXXXXXXXXXXX---?--m---------------------------m-----m------mXXm------------------------[]X--------------
-----------------------------------------------------m---m-m--------------------------------------------------m-------------------F-----m-m---m-m----mXXX-m---------------------E-[]---------------
---------?-------------------m----m-----m-----------m-----m----------------------------------------------------mm----------------------m---mmm---m--mXXXX--m----------------------[]---------------
-----------------------mm---m-m--m-m-H-m-m---------m-----XXXXX----------------------------------------------XXXXXm-------------mmmmHmmm----XXX----mmXXXXX---m---------------------[]---------------
----------------------m--mmm---mm---mmm---mmm------XX-----------------XXXX----------------------------XXXEX-------m-----m-----mXXXXXXXX-----------XXXXXXX----m--------------------[]---------------
-------QSS-----------m---XXX---XX---XXX---XXX------------------------------XXXX------------------------------------m---m-m---mXX------------------XXXXXXX-----m-------------------<>---------------
m-------------------m---------------X-----X-------------------------------------------------------------------------m-m---m-m---------------------XXXXXXX------m-------B--------m--E----m----------
XmmmmmmmmmmmmmmmmmmmX------------------------mmmmmm------------------------------------------------------------------m-----m----------------------XXXXXXX-----XXmmmmmmEEEmImmmmm-mmmmmmmEmmmmmmmmmm
XXXXXXXXXXXXXXXXXXXXX------------------------XXXXXX--------------------------------------------------------------XXXXX----XX----------------------XXXXXXXXXXXXXXXXXXXXXXXXXXXXXX-X<>XXXXXXXXXXXXXXX
XXXXXXXXXXXXXXXXXXXXX------------------------XXXXXX--------------------------------------------------------------XXXXX----X-----------------------XXXXXXXXXXXXXXXXXXXXXXXXXXXXXX-X[]XXXXXXXXXXXXXXX
XXXXXXXXXXXXXXXXXXXXX------------------------XXXXXX--------------------------------------------------------------XXXXX----X-----------------------XXXXXXXXXXXXXXXXXXXXXXXXXXXXXX-X[]XXXXXXXXXXXXXXX