----------------------------------------------------------------------------------------------------------------------------------------------------------------------------------------------------
----------------------------------------------------------------------------------------------------------------------------------------------------------------------------------------------------
----------------------------------------------------------------------------------------------------------------------------------------------SSSSSSSSSSSSSSSS--------------------------------------
----------------------------------------------------------------------------------------------------------------------------------------------SSSS-----------------------------SSSS-----------------
---------------------------------oo--oo-------------------------------------------------------------------------------------------------------SSSS--------------------------------------------------
------------------Q------oo------------------------------------------H------------------------------------------oooo----------------XXX-------SSSS--------------------------------------------------
--------------------------------------XXXX----E-------------------SSSSSSSSSSS---------SSQSSQSSS----------------------------------------------------------------------------------H------------------
--------------------------------------------XXXXXXXX------------------------------------------------------------------F------------------------------------------XXX-----------SSYS-----------------
--------------------------XX------------------------------------------------------------------------------------------------------------------------------------------------------------------------
---------------K--?---------------XX-----------------------------------H---------------------GGG------XXXXXXX-----------------XXXX------------SYSS---------XXX--------------------------------------
--------------<>---------XXXXXX-----------------------------------SSSSSSYSSSS---XXXXXXXXXXXXXXXXXXXX-----------XX--XX--XX----------------XX---SSS-------------------SSS-S------SSSS-----------------
--------------[]----------------------XXXX-------------------------------------XXXXX---------------X------------------------------------------SS--------------------SSS-S---------------------------
--------------[]----I---------------------------------------------------------XXXXXX---------------X---------------------------------------------GGG---X------------SSS-S---------------------------
XXXXXXXXXXXXXXXXXXXXXXXXX---------------------------XXXXXXXXXXXXXXXXXXXXXXXXXXXXXXXX---------------XX--------------------------------------XXXXXXXXXXXXX---------XXXSSS-SXXXXXXXXXXXXXXXXXXXXXXXXXXX
XXXXXXXXXXXXXXXXXXXXXXXXX---------------------------XXXXXXXXXXXXXXXXXXXXXXXXXXXXXXXX---------------XX--------------------------------------XXXXXXXXXXXXX---------XXXSSS-SXXXXXXXXXXXXXXXXXXXXXXXXXXX
XXXXXXXXXXXXXXXXXXXXXXXXX---------------------------XXXXXXXXXXXXXXXXXXXXXXXXXXXXXXXX---------------XX--------------------------------------XXXXXXXXXXXXX---------XXXSSS-SXXXXXXXXXXXXXXXXXXXXXXXXXXX