-------------------------------------------------------------------------------------------------------------------------------------------------------------------------------------------
------------------------------------------------------------------------------------------------------------------------------------------------------------XXX----------------------------
S-----SSSSSSSSSSSSSSSSSSSSSSSSSSSSSSSSSSSSSSSSSSSSSSSSSSS----------SSSSSSSSSSSSSSSSSSSSSSSSSSSSSSSSSSSSSSSSSSSSS-------SSSS-----SSSSSSSSSSSSSSSSSSSSSSSSSSS-----SSSSSSSSSSSSSSSSSSSSSSSSSSS
S-------------------SSSSSSSSSSSSSSSSSSSSSSSSSSSS----------------------------------------------------------------------------------------------------------------SSSSSSSSSSSSSSSS-----------
S-------------------SSSSSSSSSSSSSSSSSSSSSSSSQSSS-----------XXX--------------------------------------------------------------------------------------------------SSSSSSSSSSSSSSSS-----------
S-------------------SSSSSSSSSSSSSSSSSSSSSSSSSSSS--QQ------------SSS------------K---------------------------------------S?S--------------------------------------SSSSSSSSSSSSSSSS-----K-----
S-----------------------------------------------------------------------------<>--------------------------------------------XXX---------------------------------S-------------------<>-----
S---------------------------------------------------------------S-------------[]--------------------------------------------------------------------------------S-------------------[]-----
S------------------------------------------EEE-----------------S-S------------[]-------S--------------------K----------------------------------K------------------oooooooooo--------[]-----
S---------------------SSSSSS?-SSSSSSSSSSSSSSSSSS--QQ--Q?Q---------S------K--SQ[]SQ---K----K----------------<>------XXX-SSSS----------------K--<>-----------------?SSSSSSSSSS----XX--[]-----
S---------------------SSSSS---SSSSSSSSSSSSSSSSSS-----------XXX----------<>----[]----<>---<>-------------XX-[]--XXX------------------K-----<>--[]----------XX-------------------XXX--[]---SS
S---------------------SSSSS---SSSSSSSSSSSSSSSSSS------------------------[]----[]----[]---[]------------XXX-[]--XXX----------XXX----<>-----[]--[]--------EXXXXXX---------------XXXX--[]---SS
S--------------------------oooSSSSSSSSSSSSSSSSSS------------------------[]-G--[]--E-[]-E-[]--------G-G-XXX-[]--XXX-----------------[]---G-[]--[]--------XXXX------------GG---XXXXX-E[]---SS
XXXXXXXXXXX--XX--X---XXXXXXXXXXXXXXXXXXXXXXXXXXXXXXXXXXXX------XXXXXXXXXXXXXXXXXXXXXXXXXXXXXXXXXXXXXXXXXX--XX--XX------XXXX------XXXXXXXXXXXXXXX--XXXXXXXXX-----XXXXXXXXXXXXXXXXXXXXXXX--XX
XXXXXXXXXXX--XX--X---XXXXXXXXXXXXXXXXXXXXXXXXXXXXXXXXXXXX------XXXXXXXXXXXXXXXXXXXXXXXXXXXXXXXXXXXXXXXXXX--XX--XX------XXXX------XXXXXXXXXXXXXXX--XXXXXXXXX-----XXXXXXXXXXXXXXXXXXXXXXX--XX
XXXXXXXXXXX--XX--X---XXXXXXXXXXXXXXXXXXXXXXXXXXXXXXXXXXXX------XXXXXXXXXXXXXXXXXXXXXXXXXXXXXXXXXXXXXXXXXX--XX--XX------XXXX------XXXXXXXXXXXXXXX--XXXXXXXXX-----XXXXXXXXXXXXXXXXXXXXXXX--XX
