------------------------------------------------------------------------------------------------------------------------------------------------------------------------------------------------------------------------------
------------------------------------------------------------------------------------------------------------------------------------------------------------------------------------------------------------------------------
-------------------------------------------------------------------------------------------------------------------------------------------------------------------------------------------------SS---------------------------
---------------------------------------------------------oo--------------------------------------------------------------------------------------------------------------------------------------[]---------------------------
-------------------------------------------------------------------------------------------------------------------------------------------------------------------------------------------------[]---------------------------
-----------------------------------------XX--------XXX---------XXXX---S------------------SSS-----------------------------------------------------------------------------------------------------[]---------------------------
----------------------------------------XXX--------XXX----------[]------------------------------------------------------------------!------------------------------------------------------------[]---------------------------
---------------------------K-----------XXXX--------XXX----------[]------XXXXXXXX----------------------------------------------------F------------------------------K-----------------------------[]---------------------------
-----------------K--------<>----------XXXXX--------XXX----------[]-----XX----------------------------------X------------F--------------K--------------------------<>-----------------------------[]----------K-K--------------
----------------<>-------?[]---------XXXXXXY-------XXX----------<>----XXX--SS-------WSS-----------------SSSX--------------------------<>--------K---K-------------[]----?QQQQQQQ?----------------[]---------<><>--------------
----------------[]-F------[]--------XXXXXXX--------XXX------IQ---K----XXX------------------K-----------------------------------------X[]-------<>--<>---------F---[]-------------------------F---<>-----XXX-[][]--------------
----------------[]--------[]-------XXXXXXXX--------XXX--B-------<>----XXX------------K----<>------K-----------------------------------[]---<>--[]--[]-------------[]----B-----------------------------EXXXX-[][]--------------
----------------[]--------[]--EEE-XXXXXXXXX--------XXX--b-------[]----XXX----<>-----<>-X--[]-----<>---------------E---------GG--------[]---[]--[]--[]-------------[]----b-H-----B------------GGG------XXXXX-[][]--H-----------
XXXXXXXXXXXXXXXXXXXXXXXXXXXXXXXXXXXXXXXXXXXXX------XXXXXXXXXXXXXXXXXXXXXX----[]-----[]XXXX[]-----[]-XXXXXXXXXXXXXXXXXXXXXXXXXXXXXXXXXX[]---[]--[]XXXXXXXXXXXXXXXXXXXXXXXXXXXXX-XXXXXXXXXXXXXXXXXXXXXXXXXXXX-XXXXXXXXX----XXXXX
XXXXXXXXXXXXXXXXXXXXXXXXXXXXXXXXXXXXXXXXXXXXX------XXXXXXXXXXXXXXXXXXXXXX----[]-----[]XXXX[]-----[]-XXXXXXXXXXXXXXXXXXXXXXXXXXXXXXXXXXXX---XX--XXXXXXXXXXXXXXXXXXXXXXXXXXXXXXX-XXXXXXXXXXXXXXXXXXXXXXXXXXXX-XXXXXXXXX----XXXXX
XXXXXXXXXXXXXXXXXXXXXXXXXXXXXXXXXXXXXXXXXXXXX------XXXXXXXXXXXXXXXXXXXXXX----[]-----[]XXXX[]-----[]-XXXXXXXXXXXXXXXXXXXXXXXXXXXXXXXXXXXX---XX--XXXXXXXXXXXXXXXXXXXXXXXXXXXXXXX-XXXXXXXXXXXXXXXXXXXXXXXXXXXX-XXXXXXXXX----XXXXX