---------------------------------------------------------------------------------------------------------------------------------------------------------------------------------------------------------
---------------------------------------------------------------------------------------------------------------------------------------------------------------------------------------------------------
---------------------------------------------------------------------------------------------------------------------------------------------------------------------------------------------------------
---------------------------------------------------------------------------------------------------------------------------------------------------------------------------------------------------------
-------------------------------------------------------------------------------------------------------------------------------------m-------------------------------------------------------------------
------------------------------------------------------------------------------------------------------------------------------------m-m------------------------------------------------------------------
---------------------------------------------------------------------------------F--F-F--------------------------------------------m---m-----------------------------------------------------------------
----------------------------------------------------------------------------------------------------------------------------------m-----m----------------------------------------------------------------
---------------------------------------------------------------------------------------------------------------------------------mSS----Emm-------------------------------------E------------------------
---------------------------------------------------------------------XX-----------<>-------K------------------------------------mS-SSS-ESQQm--------------------------XXXXXX-----------------------------
----------------------------SSSSQS?-------------------------------?---X-----------[]------<>----------G------------------------m------ES----m----------------------------------XXXXXXXXXXXXXXXXXXXXXXXXXX
----------------------------------------------------------------------X-----------[]------[]----------------------------------m-------S------m---------------------------------X-------------------------
---X-----------EEE-----------------------X-----X----X----------X------X-----------[]------[]---------------EEE----GG----I----m---B------------mm-X------X---------X--------------------------------------
XXXXXXXXXXXXXXXXXXXXXXXXXXXXXXXXXXXXXXXXXXXXXXXXXXXXXXXXXXXXXXXX--S---X--XXXXXXXXXXXXXXXXXXXXXXXXXXXXXXXXXXXXXXXXXXXXXXXXXXXXXXXXXXXXXX-XXXXXXXXXXXXXXXXXXXXXXXXXXX--------------------------------------
XXXXXXXXXXXXXXXXXXXXXXXXXXXXXXXXXXXXXXXXXXXXXXXXXXXXXXXXXXXXXXXX------X--XXXXXXXXXXXXXXXXXXXXXXXXXXXXXXXXXXXXXXXXXXXXXXXXXXXXXXXXXXXXXX-XXXXXXXXXXXXXXXXXXXXXXXXXXX--------------------------------------
XXXXXXXXXXXXXXXXXXXXXXXXXXXXXXXXXXXXXXXXXXXXXXXXXXXXXXXXXXXXXXXX------X--XXXXXXXXXXXXXXXXXXXXXXXXXXXXXXXXXXXXXXXXXXXXXXXXXXXXXXXXXXXXXX-XXXXXXXXXXXXXXXXXXXXXXXXXXX--------------------------------------
