--------------------------------------------------------------------------------------------------------------------------------------------------------------------------------------------------------------------------
-----------------------------------------------------------------------------------------------------------------------------------S-S------------------------------------------------------------------------------------
--------------------------------------------------------------------------------------------------------------------------------------------------------------------------------------------------------------------------
--------------------------------------------------------------------------------------------------------------------------------------------------------------------------------------------------------------------------
-----------------------------------ooooH------------------------------------------------------------------------------------------------------G---------------------------------------------------------------------------
--------------------------XXX-----XXXXXXX-------------------------------------------------------------------------!-------QSS-------XXX------SWS--SSS----------------K--S---SSS-------------------------------------------
--------------------XXX--------------------------------------------X-------------------------------------------------------------------------------------K----------<>----------------------------------------------------
------------------------------------------------------------------XX----------------------------------------------------------------------------------W-<>----------[]----------------------------------------------------
----------------o-------X--G--X--------------W-------------------XXX--------ooo-------------Y---------------------EEE-------------------K-------------Q-[]--K-------[]-----F----------------------------------------------
---------------XXX------XXXXXXX---------------SY?---------------XXXX--------SSS-------------S---------------XXXXXXXXXXX-X--------------<>----SYS--XXSXS-XX-<>------SXXS---------------------------------------------------
---------------------------------------------------------------XXXXX----------------K---------------X------XXX--------X-X--------------[]------------------[]--K---------K-------------------X-----------F--K------X------
------------XX-------------------------------H--H-------------XXXXXX---------------<>-------S-------X-----XXXX--------X-X-X------------[]------------------[]-<>--------<>---------------Q---X-------------<>----XXX------
-----------------------------------------XXXXXXXXX----XXX----XXXXXXX---------X-----[]----K--S---E---X----XXXXX----------X-X--E-E---G--X[]------------------[]-[]--------[]-------------------X-------------[]---XXX-------
XXXXXXXXXXX----------------------------------------------XXXXXXXXXXXXX----------XXXXXXXX<>XXXXXXXXXXXXXXXXXXX-----------XXXXXXXXXXXXXXXXXXXXXXXXX<>XXXXXXXXXXXXXXXXXXXXXXXXXXXXXXXXX--XXXXXXXX--XXXXXXXXXXXXXXXXXXXXXXXXXX
XXXXXXXXXXX----------------------------------------------XXXXXXXXXXXXX----------XXXXXXXX[]XXXXXXXXXXXXXXXXXXX-----------XXXXXXXXXXXXXXXXXXXXXXXXX[]XXXXXXXXXXXXXXXXXXXXXXXXXXXXXXXXX--XXXXXXXX--XXXXXXXXXXXXXXXXXXXXXXXXXX
XXXXXXXXXXX----------------------------------------------XXXXXXXXXXXXX----------XXXXXXXX[]XXXXXXXXXXXXXXXXXXX-----------XXXXXXXXXXXXXXXXXXXXXXXXX[]XXXXXXXXXXXXXXXXXXXXXXXXXXXXXXXXX--XXXXXXXX--XXXXXXXXXXXXXXXXXXXXXXXXXX