-----------------------------------------------------------------------------------------------------------------------------------------------------------------------------------------------
-----------------------------------------------------------------------------------------------------------------------------------------------------------------------------------------------
-----------------------------------------------------------------------------------------------------------------------------------------------------------------------------------------------
-----------------------------------------------------------------------------------------------------------------------------------------------------------------------------------------------
----------------------------------------------------------------------------------------------------------------------------------------------------------------EE-----------------------------
-------------------------------------------------------------------------------SSYSSSSSSSSSS-------------------SSSWSSS-------QQ?-------------QQQ?QQQ---------SSSSSSSSSS----------------X-------
------------------------------------------------------------------------------------------------K-------------------------------------------------------------------F---------------E--X-------
------------------------------GK-------------------K-------------------------------------------<>----------------------------------------------G------------------------------------XX-X-------
------------------------------<>------------------<>-----Q--Q--?--------------------SSSSS------[]----------------------------SSS-------K-----SSSSSSS---------------------------K----XX-X-------
---------------QQQQQQQ----K-!-[]-------SSSSSSY----[]----------------SSS----------KSS----------QQQQQQ-----------SYSYSYS----------------<>--------------G--------------<>-------<>----XX-X-------
-------------------------<>---[]------------------[]---------------F------------<>-----------------------------------------X----------[]-------X------X-------F------[]-------[]----XX-X-------
---------------------G---[]---[]-------------S----[]-----------F----------------[]----------------------------------E-----------------[]-------X------X--------------[]-------[]----XX-X-------
-------------EE------X---[]---[]------------------[]---------------------X------[]----G---GG------------G-E---------------------------[]----E--X------X--------------[]-------[]----XX-X-------
XXXXXXXXXXXXXXXXXXXXXX---XXXXXXX-XXXXX--XXXXXXX---XXXXXXXXXXXXXXXXXXXX---XXXXXXXXXXXXXXXXXXXXXXX-X-XXXXXXXXXXXXXXXXX-X-X--X-------XXXXXXXXXXXXXXXXXXXXXXXXXXXXXXXXXXXXX-------XX-XXXXX-XXXXXXXX
XXXXXXXXXXXXXXXXXXXXXX---XXXXXXX-XXXXX--XXXXXXX---XXXXXXXXXXXXXXXXXXXX---XXXXXXXXXXXXXXXXXXXXXXX-X-XXXXXXXXXXXXXXXXX-X-X--X-------XXXXXXXXXXXXXXXXXXXXXXXXXXXXXXXXXXXXX-------XX-XXXXX-XXXXXXXX
XXXXXXXXXXXXXXXXXXXXXX---XXXXXXX-XXXXX--XXXXXXX---XXXXXXXXXXXXXXXXXXXX---XXXXXXXXXXXXXXXXXXXXXXX-X-XXXXXXXXXXXXXXXXX-X-X--X-------XXXXXXXXXXXXXXXXXXXXXXXXXXXXXXXXXXXXX-------XX-XXXXX-XXXXXXXX
2