---------------------------------------------------------------------------------------------------------------------------------------------------------------------------------------------------------
---------------------------------------------------------------------------------------------------------------------------------------------------------------------------------------------------------
S-----SSSSSSSSSSSSSSSSSSSSSSSSSSSSSSSSSSSSSSSSSSSSSSSSSSSSSSSSSSSSSSSSSSSSSSSSSSSS!SSSSSSSSSSSSS----------SSSSSSSSSSSSSSSSSSSSSSSSSSSSSSSSS--------------------------------------------------------------
S----------------------------------SSSSSSSSSSSSS-----------SSSS------SSSS--------------------------------------------------------------------------------------------------------------------------------
S-----------------------oooo-------SSSSS!SSSQSSS-----------SSSS--E---SSSS----------------------------------------ooooooooo-------------------------------------------------------------------------------
S-----------------------XXXX-------SSSSSSSSSSSSS--QQ--------S----SS----------oooooo---------------------SSSSSSSSSSSSSSSSSS-------------------------------------------------------------------------------
S-------------oo--------------------------------------------S----SS----------------------------------------------------------------------------XSSS-------------------S-S--------------------------------
S-----------------------------------------------------------S----SS----------SSSSSS--------------------------------------------?SSS-----------XX---------------------------------------------------------
S------------------------------------------GGG--------------So?--SQ---E------SSSSSS-------------------S----K-------------------------K-------XXX!--------------------------------------------------------
S---------------------------------XSSSSSSSSSSSSS--QW--SWS---SSS--SS--SSSS---------------------------S-S---<>-----QSS?--------K------<>-------XXX------------------XSS-?Q-----------SSS-------------------
S------------------XXXX?-----------SSSSSSSSSSSSS---------------------E----------------------------S-S-S---[]----------------<>---K--[]-----X-XXX--S--------------XX--------------------------------------
S----------------------------------SSSSSSSSSSSSS-------------------------------------------------SS-S-S---[]----------------[]--<>--[]----XX-XXX----------------XXX--------------------------------------
S----------------------------------SSSSSSSSSSSSS----------------------------------XX------------SSS-S-S---[]------EEE-------[]--[]--[]-------XXX---------------XXXX----------------EEE--------GGG--------
XXXXXXXXXXX--XXXXX-----XXXXX-XXXXX-XXXXXXXXXXXXXXXXXXXXXXXXXXXXXXXXXXXXXX---XXXXXXXXXXXXXXXXXXXXXXXXXXXXXXXXXXXXXXXXXXXXXXXXXXXXXXXXXXXXXXXXXXXXXXXXXXXXXXXXXXXXXXX---SSSSS---XXXXXXXXXXXXXXXXXXXXXXXXXXX
XXXXXXXXXXX--XXXXX-----XXXXX-XXXXX-XXXXXXXXXXXXXXXXXXXXXXXXXXXXXXXXXXXXXX---XXXXXXXXXXXXXXXXXXXXXXXXXXXXXXXXXXXXXXXXXXXXXXXXXXXXXXXXXXXXXXXXXXXXXXXXXXXXXXXXXXXXXXX-------XX-XXXXXXXXXXXXXXXXXXXXXXXXXXXX
XXXXXXXXXXX--XXXXX-----XXXXX-XXXXX-XXXXXXXXXXXXXXXXXXXXXXXXXXXXXXXXXXXXXX---XXXXXXXXXXXXXXXXXXXXXXXXXXXXXXXXXXXXXXXXXXXXXXXXXXXXXXXXXXXXXXXXXXXXXXXXXXXXXXXXXXXXXXX-------XX-XXXXXXXXXXXXXXXXXXXXXXXXXXXX
