-------------------------------------------------------------------------------------------------------------------------------------------------------------------------------------------------------------
-------------------------------------------------------------------------------------------------------------------------------------------------------------------------------------------------------------
-------------------------------------------------------------------------------------------------------------------------------------------------------------------------------------------------------------
---------------------------------------------------m---------------------------------------------------------------------------------------------------------------------------------------------------------
---------------m--------------------------------m-m-mmmmmmmmmmmmmmmmmmmmmmmmmmmmmmmmmm------------------------------------------------I----------------E-----------------------------------------------------
--------------m-m------------------------------m-m--XXXXXXXXXXXXXXXXXXXXXXXXXXXXXXXXXX----------------------------------------------SSS-----K------SSSYSSQSWSSSQSSS-----K------------------------------------
-------------m---m----------------------------m--X----------------------------------[]---------oooo----------------------------------------<>--------------------------<>------------------------------------
---m--------m-----m--------------------------m--------------------------------------[]-----------------------------------------------------[]--------------------------[]--------------------oo--------------
-----------m------Emm-----------------mmmmmmm---------------------------------------[]-------K---------------------------------------G-----[]-------H------------------[]------------------------------------
----m-----mSSSS?SSSQQm--------<>-----mXXXXXXX---------------------------------------[]------<>---------------SSQS------------------SSSS----XXX---SSSSSSSSSSSSYSSSSS----[]------------------------------------
-----m---m------------m-------[]----mXXXX-------------------------------------------<>------[]-------------------------B------B----------------------------------------[]-----------------XX-----------------
------m-m-----------B--m-----m[]---mXXXXX---------------------------------------------------[]-------------------------b------b----------------------------------------[]-------S--------XXX-----------------
---X--Em------------b---mmmmmX[]mmmXXXXXX--------------------------------------------Emmmm--[]--------E----------------B------B------------E--mmm----------------------[]---------------XXXX---S----mmmmmmmmm
XXXXXXXXXXXXXXXXX-XXXXXXXXXXXXXXXXXXXXXX-----------XXXXXXXXXXXXXXXXXXXXXXXXXXXXXXXXXXXXXXXXXXXXXXXXXXXXXXXXXXXXXXXXXXXXXXXXXXXXXXXXXXXXXXXXXXXXXXXXXXXXXXXXXXXXXXXXXXXXXXXXXXX------XXXXXXXX--------XXXXXXXXX
XXXXXXXXXXXXXXXXX-XXXXXXXXXXXXXXXXXXXXXX-----------XXXXXXXXXXXXXXXXXXXXXXXXXXXXXXXXXXXXXXXXXXXXXXXXXXXXXXXXXXXXXXXXXXXXXXXXXXXXXXXXXXXXXXXXXXXXXXXXXXXXXXXXXXXXXXXXXXXXXXXXXXX------XXXXXXXX------XXXXXXXXXXX
XXXXXXXXXXXXXXXXX-XXXXXXXXXXXXXXXXXXXXXX-----------XXXXXXXXXXXXXXXXXXXXXXXXXXXXXXXXXXXXXXXXXXXXXXXXXXXXXXXXXXXXXXXXXXXXXXXXXXXXXXXXXXXXXXXXXXXXXXXXXXXXXXXXXXXXXXXXXXXXXXXXXXX------XXXXXXXX------XXXXXXXXXXX