-----------------------------------------------------------------------------------------------------------------------------------------------------------------------------------------------------------------
-----------------------------------------------------------------------------------------------------------------------------------------------------------------------------------------------------------------
-------------------------------------------------------------------------------------------------------------------------------------------------------------SSSSSSSSSSS-SSSSSSSSSSSSSSSSSSSISSSSSSSSSSSSSS------
--------------------------------------------------ooo------------------------------------------------------------------------------------------------------------------------SSSSSSSSSS--S---SSSSSSSSSSSSSS------
-----------------------------------------------------------------------------------------------------------------------------------------------------------------------------SSSSSSSSSS--S---SSSSSSSSSSSSSS------
---------------------------------I---------------XXXX----------------------------------------------W---------XX-----------------------H-----------XX----------------!--------SSSSSSSSSS--S---SSSSSSSSSSSSSS------
----------------------------SSSSSS------------------------------------------------oooo---------------S--F----[]----------------------SSSS-----F---[]-------------------------------------------------------------
---------------------------------------------------------XXX----------------------------F------------SS------[]---------------B-------------------[]--SS----------------------------------K----------------------
--------------------------------I-ooo----------------------------------------------------------X-E-X-SS------[]---I-----------b----H--H-----------[]--SY------------EEE------------------<>---------------K------
------------------FG-------?SSSSSSSSS-------------------------------------XXX----G-------------X-----XXXXX---<>SSSSSS--------XXX--SWSSSSS---X-----<>SSSS------XXXXXXXXXX-YYYYSSSSSSSSSS--[]--------------<>------
------------XX---XXX-----------------------------K-------XXX-----------F--------XXX--XX-------------------------------------XXXX---------GG------------------XXX-------X-SSSS------------[]----------XXX-[]------
-----------XXX--X-------------------H-----------<>----------------------X--------------------------------------------------XXXXX--SSSSSSSSSSX----------------XXX-------X-SSSS------------[]--------EXXXX-[]------
----------XXXX-------------------XXXXXXXXX------[]--------------H----------------K-------XX--------GGG----------K---------XXXXXX----------------EEE--K-------XXX-------X-----------------[]------E-XXXXX-[]------
XXXXXXXXXXXXXX--------------XXXXXX------XX-XXX-X[]XXXXX-------XXXXXXXXX---------<>---------XXXXXXXXXXXXXXX--XXX<>XXXXXXXXXXXXXXXXXXXXXXXXXXXXXXXXXXX<>XXXXXXXXX--------XXXXXXXXXXXXXXXXXXXXXX-XXXXXXXXXX-XXXXXXXX
XXXXXXXXXXXXXX--------------XXXXXX------XX--------------------------------------[]---------XXXXXXXXXXXXXXX--XXX[]XXXXXXXXXXXXXXXXXXXXXXXXXXXXXXXXXXX[]XXXXXXXXX--------XXXXXXXXXXXXXXXXXXXXXX-XXXXXXXXXX-XXXXXXXX
XXXXXXXXXXXXXX--------------XXXXXX------XX--------------------------------------[]---------XXXXXXXXXXXXXXX--XXX[]XXXXXXXXXXXXXXXXXXXXXXXXXXXXXXXXXXX[]XXXXXXXXX--------XXXXXXXXXXXXXXXXXXXXXX-XXXXXXXXXX-XXXXXXXX