-------------------------------------------------------------------------------------------------------------------------------------------------------------------------------------------------------------------------------
-------------------------------------------------------------------------------------------------------------------------------------------------------------------------------------------------------------------------------
-------------------------------------------------------------------------------------------------------------------------------------------------------------------------------------------------------------------------------
------------------------------------------------------------------------------------------------------------------------------------------------XXXX---------------------------------------------------------------------------
-------------------------------------------------------------------------------------------K----------------------------------------------------X------------------------------------------------------------------------------
------------------------------------------------------------X-----------------------------<>------------------K------------------XXXXXXXXXXXXXXXX----------------------------------SSSSSS----------------------X---------------
------------------------------------------------------------X----------oooo---------------[]-----------------<>-------------------[]-------------------------------------------------------------------------------------------
-----------------------------------------------------------------------------F-----------X[]-----------------[]-------------------[]------SSSS-------------K-------------------------------------------------X-----------------
--------------------------------------------------------------------------------------K---[]----------F------[]-------------------[]----------------------<>-------------------B--I----------------------K---------------------
--------------------------------------SSSYSWSSS----------------XXX--------------XXX--<>---[]---------------WS[]-------------------[]----------------------[]----?QQQQQQQQ-----XXXXXSSSSSS---------------<>---------------------
------------------XX---XXX-----------------------B----------F---------XX--XX---------[]---[]------oo---------[]-------------------<>---------B------------[]-----------------XXXXXX---------------------[]---------------------
-----------------XXX-F---------F-------------H---b-----------X-----------------------[]---[]------oo---------[]------------H-----------------b------------[]----B-----------XXXXXXX---------------------[]---------------------
----------------XXXX--------------XXXXXXXXXXXXXXXXX---------------------------XX-----[]---[]----------I------[]------B---SSSS----------------B-----------X[]X---b-H-----B--XXXXXXXX-------I--B----------[]---------EEE---------
XXXXXXXXXXXXXXXXXXXX--------------XX-------------XX-XXXXXXXX-------------------------[]---XX-XXXXXXXXXXXXXXXXXXXXXXXXXXXXXXXXXXXXXXXXXX--XX--XX--XXXXXXXXXXXXXXXXXXXXX-XXXXXXXXXXXXXXXXXXXXXXX--------XXXXXXXXXXXXXXXXXXXXXXXXX
XXXXXXXXXXXXXXXXXXXX--------------XX-------------XX----------------------------------[]---XX----XXXXXXXXXXXXXXXXXXXXXXXXXXXXXXXXXXXXXXX--XX--XX--XXXXXXXXXXXXXXXXXXXXX-XXXXXXXXXXXXXXXXXXXXXXX--------XXXXXXXXXXXXXXXXXXXXXXXXX
XXXXXXXXXXXXXXXXXXXX--------------XX-------------XX----------------------------------[]---XX----XXXXXXXXXXXXXXXXXXXXXXXXXXXXXXXXXXXXXXX--XX--XX--XXXXXXXXXXXXXXXXXXXXX-XXXXXXXXXXXXXXXXXXXXXXX--------XXXXXXXXXXXXXXXXXXXXXXXXX