------------------------------------------------------------------------------------------------------------------------------------------------------------------------------------------------------------------
------------------------------------------------------------------------------------------------------------------------------------------------------------------------------------------------------------------
--------------------------------------------------------ooo----------------------------------------------------!WSSSS---------------------------------------------------------------------------------------------
------------------------------------------------------------------------------------------------------------------------------------------------------------------------------------------------------------------
---------------------------------------------------------G--------------------------------------------------------------------------------------------------oo--------------XXX-----------------------------------
--------------------------------------------------------XXX-------SSSSQ------------------------F-XXX-----o---XXXX?------------------SYS-----K-------------------------------------------F--EXXX--------------XX---
----------------------------------------------W------------------------------K--------------------------XX---------------------------------<>---------------------------------------------EXXXX--------------XX---
--------------------------------------------------F---X---------------------<>-------------------------------------------------------------[]---------------------------------------------XXXXX------------XXXX---
--------------------------------------SY------------------------------------[]-------------------------------------------------------------[]----o------K-------------------------------KXXXXXX------------XXXX---
--------------------------------------SS-----XXXXXXXX-----------------K-----[]------K----------------------XX---XX------------K-XX--SSS----XX----------<>------------------------------<>XXXXXX----------XXXXXX---
------------------------------K---------------------------------K----<>---K-[]-----<>--------------------------------------X-<>-XX---------------------[]----------K-------------------[]XXXXXX----------XXXXXX---
-----------------------------<>-------SSS----------------------<>----[]G-<>-[]-----[]-------------------XX----------------XX-[]-XXX--------------------[]---------<>----------------<>X[]XXXXXX----------XXXXXX---
-------------E---------------[]----K--SSS----------------------[]----[]--[]-[]---E-[]-----EEE----------------------------XXXX[]-XXX-E------I-----------[]--EEE----[]-G-----EEE-I----[]X[]XXXXXX------H---XXXXXX---
XXXXXXXXXXXXXXXX-----XXXXXXXXXXXXX<>XXXXXXXXX--------------XXXXXXXXXXXXXXXXXXXXXXXXXXXXXXXXXXXXXX---XXXX-----XXXX-XXXXXXXXXX-XXXXXXXXXXXXXXXXXXXXXXXXXXXXXXXXXXXXXXXXXXXXXXXXXXXXXXXXXXXXXXXXXXXXXXXXXXXXXXXXXXXXX
XXXXXXXXXXXXXXXX-----XXXXXXXXXXXXX[]XXXXXXXXX--------------XXXXXXXXXXXXXXXXXXXXXXXXXXXXXXXXXXXXXX---XXXX-----XXXX-XXXXXXXXXX-XXXXXXXXXXXXXXXXXXXXXXXXXXXXXXXXXXXXXXXXXXXXXXXXXXXXXXXXXXXXXXXXXXXXXXXXXXXXXXXXXXXXX
XXXXXXXXXXXXXXXX-----XXXXXXXXXXXXX[]XXXXXXXXX--------------XXXXXXXXXXXXXXXXXXXXXXXXXXXXXXXXXXXXXX---XXXX-----XXXX-XXXXXXXXXX-XXXXXXXXXXXXXXXXXXXXXXXXXXXXXXXXXXXXXXXXXXXXXXXXXXXXXXXXXXXXXXXXXXXXXXXXXXXXXXXXXXXXX