-----------------------------------------------------------------------------------------------------------------------------------------------------------------------------------------------------------------
-----------------------------------------------------------------------------------------------------------------------------------------------------------------------------------------------------------------
---------------SS-------------------XXXX-------------------------------------------------------------------------------------------------------------------------------------------------------------------------
---------------[]--------------------[]--------------------------------------------------------------------------------------------------------------------------------------------------------------------------
---------------[]--------------------[]---------------------------------------------------------------------------------------------------------------I----------------------------------------------------------
---------------<>--------------------[]------------------------------------------XX--------------WSSS-----------------------------------------------SSSSS-----SSSSW---------X----K---------------------X---------
-------------------------------------[]-----------------------------------F--F---[]---------------[]-----------------------------------------------S-----------[]---------------<>-------------------------------
-------------------------------------[]------------------------------------------[]---------------[]------------------------F---------------------SS-----------[]---------------[]-----------------K-------------
---------------K---------------------[]--------------------------------F---------[]---------------[]---------------------------------------------SSS-------?---[]---------K-----[]----------------<>-------------
--------------<>---QQQQQQ?QQQQQQQIQ--<>-------X----------------------------------[]---------------[]-----------------------S---S----------------WSSS-----------<>--------<>-----[]------------Y---[]-------------
--------------[]------------------------------X----------------------------------<>-----B---------<>-----------K---------------------------------------------------------[]-----[]----------------[]-------------
--------------[]--------------------------F---X-----------------------------------------b---------------------<>-X-X---------------------F-------------------------------[]-----[]----------------[]-------------
--------------[]-----E---EE-----GG-----------FX-------H----E-E----X---------------------B-----E---------I-----[]-X-X--------------------K-------B------------B--------H--[]-----[]------K---------[]------------X
XXXXXXXXXXXXXXXXXXXXXXXXXXXXXXXXXXXXXXXXXXXXXXX-----XXXXXXXXXXXXXXX-------------XXXXXXXXXXXXXXXXXXXXXXXXXXXXXXXXXXXX-------------XXXXXX<>XXXXXXXXXXXXXXXXXXXXX-XXXXXXXXXXXX-----XXXXXXX<>XXXXXX---XXXXXXX-------X
XXXXXXXXXXXXXXXXXXXXXXXXXXXXXXXXXXXXXXXXXXXXXXX-----XXXXXXXXXXXXXXX-------X-----XXXXXXXXXXXXXXXXXXXXXXXXXXXXXXXXXXXX-------------XXXXXX[]XXXXXXXXXXXXXXXXXXXXX-XXXXXXXXXXXX-----XXXXXXX[]XXXXXX---XXXXXXX-------X
XXXXXXXXXXXXXXXXXXXXXXXXXXXXXXXXXXXXXXXXXXXXXXX-----XXXXXXXXXXXXXXX-------X-----XXXXXXXXXXXXXXXXXXXXXXXXXXXXXXXXXXXX-------------XXXXXX[]XXXXXXXXXXXXXXXXXXXXX-XXXXXXXXXXXX-----XXXXXXX[]XXXXXX---XXXXXXX-------X
